

-WWWWWWWWWWWWWWWWWWWWWWWWWWWWWWWWWWWWWWWWWWWWWWWWWWWWWWW-
-W---------------------W-------------------------------W-
-W---------------------W-------------------------------W-
-W---------------------W-------------------------------W-
-W---------------------WWWW----------------------------W-
-W------------------------W----------------------------W-
-W------------------------W----------------------------W-
-W------------------------WW---------------------------W-
-W-----------W-----------------------------W-----------W-
-W-----------W-----------------------------W-----------W-
-W-----------------------------------------------------W-
-W-----------------------------------------------------W-
-W-----------W-----------------------------W-----------W-
-W-----------W-----------------------------W-----------W-
-W-----------W-----------------------------W-----------W-
-W-----------------------------------------------------W-
-W-----------------------------------------------------W-
-W-----------------------------------------------------W-
-W-----------W-----------------------------W-----------W-
-W-----------W-----------------------------W-----------W-
-W-----------------------------------------------------W-
-W------------------------WW---------------------------W-
-W------------------------W----------------------------W-
-W------------------------W----------------------------W-
-W---------------------WWWW----------------------------W-
-W---------------------W-------------------------------W-
-W---------------------W-------------------------------W-
-W---------------------W-------------------------------W-
-WWWWWWWWWWWWWWWWWWWWWWWWWWWWWWWWWWWWWWWWWWWWWWWWWWWWWWW-